I - я
you - ты, вы
he - он
his - его
it - он, она, оно (о неодушевленных предметах)
they - они
is - является, находится
was - был, была, было
are - являемся, являетесь, являются
and - и
as - как, так как, когда
for - для, ради, из-за
in - в, в течение, через, на
of - чего-то (с существительным в родительном падеже)
on - на, у в
that - что, та, тот, то
with - с, вместе с
to - к, в, на
the - определенный артикль - эта, этот, это
a - неопределенный артикль перед существительным единственного числа
word - слово
all - все, всё, вся, весь
this - этот, эта, это
one - один, единица, некто
we - мы
your - твой, ваш, твои, ваши
be - быть, находиться
have - иметь
had - имел
were - были, находились
can - уметь, мочь, быть в состоянии
said - сказал, сказала, сказали
at - у, при, на, в
from - от, из, с
or - или, ни
by - при, около, к, мимо, с помощью
but - но, а, кроме, однако
not - не, ни
what - какой, сколько
when - когда, в то время как
use - использование, применение, польза
many - многие, много
other - другой, иной
each - каждый, всякий
she - она
their - их, принадлежащий им
them - ним/них
these - эти
which - какой, который
do - делать, осуществлять
will - воля, намерение +вспомогательный глагол для образования будущего времени
how - как, сколько
so - таким образом, так, тоже, поэтому
then - тогда, потом
there - там, туда, здесь
about - вокруг, около, о, приблизительно
if - если
out - вне, за, снаружи, вне
up - вверх, вдоль по, наверху, выше
an - неопределенный артикль a + буква n, используется перед гласными
time - время, срок
number - число, количество, цифра
way - дорога, путь, направление, возможность
people - люди, население
her - нее, ней, ее, принадлежащее ей
him - ему, нему
some - которые, кое-кто,некоторый, какой-то, несколько
more - больше
would - модальный глагол, может переводиться как частица «бы»
make - делать, создавать, заставлять
like - нравиться, любить, хотеть, похожий, равный
has - имеет, обладает
look - смотреть, глядеть, выглядеть
write - писать, написать
go - идти, ходить, ехать, уехать
see - видеть, осматривать, знать, понимать
could - мог/могли
no - нет, не, никакой
two - два, двойка
into - в, внутрь
day - день, сутки
oil - масло, смазка, нефть
part - часть, доля, участие, роль, отделяться, расставаться
water - вода, смачивать, поливать
long - длинный, долгий, медленный
my - мой, мои
its - его, ее, свой
who - кто, который
been - причастие прошедшего времени глагола be «быть»
call - звать, звонить, оклик, звонок, посещение
find - находить, приобрести, считать
did - делал, делали
get - получать, добиваться, становиться
come - приходить, приезжать, происходить
made - делал, делали, создал, создали
may - мочь, иметь возможность
now - сейчас, теперь
first - первый
down - вниз, внизу
than - чем