hello - здравствуйте, привет
sorry - извини(те)
please - пожалуйста (прошу); угождать
thank you - спасибо
you are welcome - пожалуйста, не за что
goodbye - до свидания
people - люди
man - мужчина
woman - женщина
child - ребёнок
boy - мальчик
girl - девочка
friend - друг
guest - гость
family - семья
parents - родители
father - отец
mother - мать
husband - муж
wife - жена
son - сын
daughter - дочь
brother - брат
sister - сестра
grandfather - дед
job - работа
teacher - учитель
driver - водитель
worker - рабочий
engineer - инженер
doctor - врач
nurse - медсестра
shop assistаnt - продавец
waiter - официант
student - студент, школьник
animal - животное
cat - кошка
dog - собака
bird - птица
country - страна; сельская местность
Russia - Россия
England - Англия
city - город
house - дом (здание)
home - дом (место проживания)
building - здание; строительство
place - место; помещать
centre - центр
school - школа
theater - театр
church - церковь
restaurant - ресторан
hotel - гостиница
cinema - кинотеатр
hospital - больница
post office - почта
station - станция, вокзал
shop - магазин
factory - предприятие, завод, фабрика
square - площадь
street - улица
road - дорога
stop - остановка; останавливаться
garden - сад
river - река
mountain - гора
tree - дерево
flat - квартира
room - комната
living room - зал
bedroom - спальня
bathroom - ванная
shower - душ
kitchen - кухня
hall - коридор
balcony - балкон
floor - пол; этаж
wall - стена
door - дверь
window - окно
furniture - мебель
table - стол
chair - стул
armchair - кресло
sofa - диван
bed - кровать
wardrobe - (платяной) шкаф
shelf - полка
mirror - зеркало
carpet - ковер
fridge - холодильник
food - еда
bread - хлеб
butter - масло
cheese - сыр
sausage - колбаса, сосиска
meat - мясо
chicken - цыпленок; курица
fish - рыба; рыбачить
egg - яйцо
salad - салат
mushroom - гриб
corn - кукуруза; зерно
porridge - каша
soup - суп
sandwich - бутерброд
rice - рис
pepper - перец; поперчить
salt - соль; посолить
onion - лук (репчатый)
vegetables - овощи
potatoes - картофель
carrot - морковь
tomato - помидор
cucumber - огурец
cabbage - капуста
nut - орех
fruit - фрукт(ы); плод
apple - яблоко
banana - банан
berry - ягода
grape - виноград
orange - апельсин; оранжевый
lemon - лимон
sugar - сахар
honey - мёд
jam - варенье
cake - торт, пирожное
bun - булочка
cookie - печенье
pie - пирог, пирожок
sweet - конфета; сладкий
ice-cream - мороженое
chocolate - шоколад
water - вода; поливать
soda - газировка
juice - сок
tea - чай
coffee - кофе
milk - молоко
cup - чашка
glass - стакан; стекло
plate - тарелка
spoon - ложка
fork - вилка
knife - нож
saucer - блюдце
bottle - бутылка
napkin - салфетка
breakfast - завтрак
lunch - обед
dinner - ужин
plane - самолет
car - автомобиль
tram - трамвай
bus - автобус
train - поезд
ship - корабль
bicycle - велосипед
time - время; раз
minute - минута
hour - час
week - неделя
year  - год
holiday - праздник; отпуск; каникулы
party - вечеринка
yesterday - вчера
today - сегодня
tomorrow - завтра
day - день
morning - утро
afternoon - день (после полудня)
evening - вечер
night - ночь
Monday - понедельник
Tuesday - вторник
Wednesday - среда
Thursday - четверг
Friday - пятница
Saturday - суббота
Sunday - воскресенье
month - месяц
January - январь
February - февраль
March - март
April - апрель
May - май
June - июнь
July - июль
August - август
September - сентябрь
October - октябрь
November - ноябрь
December - декабрь
spring - весна
summer - лето
autumn - осень
winter - зима
name - имя, название
birthday - день рождения
address - адрес
married - женатый/замужняя
thing - вещь
pen - ручка
pencil - карандаш
book - книга
copybook - тетрадь
letter - письмо; буква
paper - бумага
(tele)phone - телефон
clock - часы
comb - расчёска; расчесывать
TV(-set) - телевизор
iron - утюг; железо; гладить (утюгом)
flower - цветок
soap - мыло; намыливать
bag - сумка
present - подарок
ball - мяч
toy - игрушка
ticket - билет
key - ключ; клавиша
lamp - лампа
glasses - очки
towel - полотенце
box - коробка, ящик; боксировать
clothes - одежда
shoes - обувь
coat - пальто
dress - платье; одевать(ся)
suit - костюм; иск; подходить, быть к лицу, соответствовать
shirt - рубашка
blouse - блузка
skirt - юбка
glove - перчатка
hat - шляпа; шапка
cap - кепка; колпачок
jacket - пиджак; куртка
scarf - шарф
sock - носок
sweater - свитер
T-shirt - футболка
tie - галстук; привязывать
trousers - брюки, штаны
shorts - шорты
weather - погода
sun - солнце
wind - ветер
rain - дождь
snow  - снег
sky - небо
music - музыка
song - песня
picture - картина; фотография
money - деньги
bill - счёт
love - любовь; любить
hate - ненависть; ненавидеть
luck - удача
problem - проблема
question - вопрос
what - что; какой
who - кто
where - где; куда
how - как
why - почему, зачем
when - когда
how many - сколько (+ слово во множественном числе)
how much - сколько (+ слово в единственном числе)
I - я
you - ты; вы; Вы
he - он
she - она;
it - оно
we - мы
they - они
my - мой
your - твой; ваш
his - его (одуш.)
her - её
its - его (неодуш.)
our - наш
their - их
from - из
of - передает род. падеж
to - к; в (куда)
in - в (где)
on - на
under - под
with - с
without - без
near - возле, около; близко
for - для; в течение; на (такое-то время)
about - о; около, приблизительно
number - число; количество; номер
zero - ноль
one - один; (заменяет предыдущее названное существительное, во мн.ч. - ones)
two - два
three - три
four  - четыре
five - пять
six - шесть
seven - семь
eight - восемь
nine - девять
ten - десять
eleven - одиннадцать
twelve - двенадцать
thirteen - тринадцать
fourteen - четырнадцать
fifteen - пятнадцать
sixteen - шестнадцать
seventeen - семнадцать
eighteen - восемнадцать
nineteen - девятнадцать
twenty - двадцать
thirty - тридцать
forty - сорок
fifty - пятьдесят
sixty - шестьдесят
seventy - семьдесят
eighty - восемьдесят
ninety - девяносто
hundred - сто
thousand - тысяча
colour - цвет
black - чёрный
blue - голубой; синий
brown - коричневый
green - зелёный
grey - серый
red - красный
white - белый
yellow - жёлтый
pink - розовый
old - старый
young - молодой
new - новый
big - большой
small - маленький
hungry - голодный
good - хороший; добрый
bad - плохой
early - ранний; рано
late - поздний; поздно
last - последний, прошлый
next - следующий
free - свободный; бесплатный
busy - занятый
hot - жаркий; горячий; острый (по вкусу); жарко; горячо
warm - тёплый; тепло
cold - холодный; холодно; холод; простуда
stupid - глупый, тупой
clever - умный
nice - красивый, хороший, приятный
beautiful - красивый
high - высокий
tall - высокий (о росте)
short - короткий; низкий (о росте)
long - длинный; долгий
heavy - тяжёлый
light - лёгкий; светлый; свет
difficult - трудный, тяжелый
easy - легкий, нетрудный
dark - тёмный
expensive - дорогой
cheap - дешёвый
poor - бедный; плохой
rich - богатый
healthy - здоровый
sick - больной
left - левый; cлева; налево
right - правый; правильный; справа; направо; право; прямо (напр., прямо сейчас)
wrong - неправильный
fast - быстрый, быстро
slow - медленный
sad - печальный
glad - радостный
happy - счастливый
angry - сердитый
clean - чистый; чистить, прибираться
dirty - грязный
tired - усталый
comfortable - удобный, комфортабельный, уютный
tasty - вкусный
ready - готовый
careful - внимательный; осторожный
sometimes - иногда
never - никогда
rarely - редко
usually - обычно
often - часто
always - всегда
soon - скоро
well - хорошо; колодец
yes - да
no - нет
not - не
this - этот
that - тот; что (союз); который
many - много (+ слово во множественном числе)
much - много (+ слово в единственном числе)
few - мало (+ слово во множественном числе)
little - мало (+ слово в единственном числе); маленький
some - несколько; немного; некоторое количество (в утверждениях)
any - несколько; немного; некоторое количество; какой-нибудь (в вопросах); никакой (в отрицаних); любой (в утверждениях)
nobody - никто
nothing - ничто
here - здесь; сюда
there - там; туда
now - сейчас, теперь
then - потом; тогда
very - очень
every - каждый
(an)other - другой
all - все; всё; весь
so - так; таким образом; итак; поэтому
up - вверх
down - вниз
together - вместе
too - тоже; слишком
only - только
and - и
or - или
but - но
because - потому что, так как
if - если; ли
be - быть, являться
do - делать (действовать)
have - иметь
can - мочь (быть в состоянии)
go - идти; ехать; уходить; уезжать
find - находить
stand - стоять
sit - сидеть
hear - слышать
get - получать; добираться; становиться
make - делать (изготовлять)
come - приходить, приезжать
run - бежать
see - видеть
write - писать
take - брать
give - давать; дарить
forget - забывать
eat - кушать
say - сказать
pay - платить
drink - пить
swim - плавать
sing - петь
begin - начинать
fly - летать
know - знать
draw - рисовать, чертить
speak - разговаривать
choose - выбирать
break - ломать
show - показывать
cut - резать
put - помещать, ставить, класть
let - позволять
read - читать
send - посылать
spend - проводить (время); тратить
build - строить
feel - чувствовать
meet - встречать
sleep - спать
leave - покидать; оставлять; уходить; уезжать
buy - покупать
bring - приносить, привозить
teach - учить, обучать
think - думать
must - быть должным
will - для образования буд. времени
live - жить
work - работать; работа
watch - смотреть; наблюдать; наручные часы
wash - мыть, cтирать
try - пытаться, пробовать; попытка
celebrate - праздновать
smile - улыбаться; улыбка
laugh - смеяться
cry - плакать, кричать; плач, крик
learn - учить(ся)
change - (из)менять; переодеваться; изменение; сдача, мелочь
listen - слушать
close - закрывать
open - открывать; открытый
dance - танцевать
ask - спрашивать; просить
answer - отвечать; ответ
want - хотеть
like - нравиться, любить; подобно, как
cook - варить; готовить
wait - ждать
play - играть; спектакль, пьеса
call - звать; звонить
walk - гулять; идти пешком; прогулка
remember - (за)помнить; вспомнить
stay - оставаться; останавливаться (в гостинице)
help - помогать; помощь
visit - посещать; посещение, визит
jump - прыгать; прыжок
travel - путешествовать; путешествие
talk - разговаривать; разговор
surprise - удивлять; удивление; сюрприз
worry - беспокоить(ся); беспокойство
joke - шутить; шутка